#####################
# . . . . . . . . . #
# . . . . . . . . . #
# . . T . . . . . . #
# . . . . . . . . . #
# . . . . . . . . . #
# . . . . . . . . . #
# . . . . . . . . . #
# . . . . . . . F . #
# . . . . . . . . . #
#####################
