#####################
# . . . # . . . . . #
# . . . # . . . . . #
# . . T O . . . . . #
# . . . # . . . . . #
################O####
# . . . . . . . . . #
# . . . . . . . . . #
# . P . . . . . F . #
# . . . . . . . . . #
#####################
