#####################
# . . . . . . . . . #
# . . . . . . . . . #
# . . T . . . . . . #
# . . . . . . . . . #
# . . . . . . . . . |
# . . . . . . . . . #
# . . . . . . . . . #
# . o . . . . . F . #
# . . . . . . . . . #
#####################
